MMMMMEMMMMMM
MPPPPPPPPPPM
MPMMMMMMMMPM
MPPPPPPPPMPM
MPMMMMMMPMPM
MPMMMMMMPMPS
MMMMMMMMMMMM