MMMMEMMMMMMMMMMMMM
MPPPPPPPMMPPPPMMMM
MPMMMMMPMMPMMPPPPM
MPMMMMMPMMPMMPMMMM
MPMMMMMPMMPMMPPPPM
MPPPPPPMMMPMMPMMPM
MMMMMMPMMMPMMPMMPM
MMMMMMPPPPPMMPMMPM
MMMMMMMMMMMMMMMMPM
MMMMMMMMMMMMMMMMPM
MPPPPPPPPPPPPPPPPM
MPMPMPMPMPMPMPMPMM
MPMPMPMPMPMPMPMPMM
MPMPMPMPMPMPMPMPMM
MPMPMPMPMPMPMPMPMM
MPPPMPPPMPMPPPMPMM
MMMMMMMPMMMMMMMMMM
MMMMMPPPPPMMMMMMMM
MMMMMPMPMPMMMMMMMM
MPPPPPMMMPPPPPPPPS
MMMMMMMMMMMMMMMMMM