MMMMEMMMM
MMMMPMMMM
MMMMPMMMM
MMMMPMMMM
MMMMSMMMM