MMMMMMMMMMMMMMMMMMMMM
EPPPPPMPPPPPPPPPPPPPM
MMMMMPMPMMMMMMMMMMMPM
MPPPPPMPPPMPPPPPPPMPM
MPMMMMMPMMMPMMMMMPMPM
MPPPPPMPPPMPPPMPMPPPM
MMMMMPMMMPMMMPMPMMMMM
MPPPMPPPMPMPMPPPMPPPM
MPMMMMMPMPMPMMMPMPMPM
MPPPPPPPMPPPMPPPMPMPM
MMMMMPMMMPMMMMMPMPMPM
MPPPPPMPPPMPPPMPMPMPM
MPMMMMMPMMMMMPMPMPMPM
MPMPPPPPMPPPPPPPPPMPM
MPMPMMMMMPMMMMMMMMMPM
MPMPMPMPPPMPPPMPPPPPM
MPMPMPMPMMMPMMMPMMMMM
MPPPMPPPMPPPPPPPMPPPM
MMMMMPMMMPMPMMMMMMMPM
MPPPPPMPPPMPPPPPPPPPS
MMMMMMMMMMMMMMMMMMMMM