MEMMMMMM
MPPPPPPM
MMMMMMPM
MPPPPPPM
MSMMMMMM